#########
d.......#
#.......#
#.......#
#########