############
#..........#
#..........#
#..........#
##....####.#
 #.####  ###
 #.#
 #.#######
 #.......#
 #.#####.#
##.#   #.#
#..# ###.#
##.# #...#
 ### #####