###########W####W####DD#######
W........#...#...............#
W...L....#.L.#..L............#
#........#...#...........L...#
D........##D##..#####........#
#######.........#...#........#
#.....D.........D.L.#..####D##
W.....#....##########..#.D...#
W..L..#.L..#...L....D..###.L.#
#.....#....#........##D#.#...#
########WW###########..#.D...#
                    D..###WW##
                    ##W#