              #W#W#W#W#W#W##
              W............W
  #W#W#W#W#W#W#...###......#        #W#W#W#W#W##
  W...........D...# #......W        W..........#
  #.####D######...###......#W#W#W#W##.#........W
  W.W  #.#    #.......................#........#
  #.# ##D#######...........##W#W#W#W#.#........W
 ##.# #........#D#D#W#W#W#W#        #.##########
 #..# #..........#.W                W..........W
 #.## #W#W#W#W#W##.#       #W#W#W#W##.......#W##
 #.#             W.W       #................W
##D#W#W#W#W#     #.#       W................#
W..........#  #W##D##W#W#W##................W
#..........#  W....#....#...................#
W..........#  #....#....D...................W
#..........##W#....D....#W#W#W#W##D##W#W#W#W#
W..........D..D....#....#       #...# 
#W#W#W#W#W##W##....#....W     ###...###
              #W#W###W#W#     W.......W
                              W.......W
                              W.......W
                              ##.....##
                               ##...##
                                #WWW#