      ##d##########
#######...........#
#....##...........#
#....##...........#
#.....D...........#
############D######